BLOOD PRESSURE 56/41 - IN AND OUT OF CON
CHEST PAIN – ACTIVE MI SUSPECTED
UNCONSCIOUS – NOT BREATHING
DIABETIC – LOW BLOOD SUGAR
FALL – POSSIBLE HIP FRACTURE
DIFFICULTY BREATHING – ASTHMA HISTORY
STROKE – FACIAL DROOP, SLURRED SPEECH
ALLERGIC REACTION – EPI GIVEN
OVERDOSE – NARCAN ADMINISTERED
SEIZURE – POST ICTAL STATE
ABDOMINAL PAIN – NAUSEA AND VOMITING
OBSTETRICS – ACTIVE LABOR
HEMORRHAGE – LEG LACERATION
ALTERED MENTAL STATUS – UNKNOWN CAUSE
PSYCHIATRIC – SUICIDAL IDEATION
CARDIAC ARREST – CPR IN PROGRESS
HEAD INJURY – FALL FROM HEIGHT
BACK PAIN – NON TRAUMATIC
EYE INJURY – CHEMICAL EXPOSURE
TOOTHACHE – SWELLING PRESENT
SYNCOPE – HISTORY OF HEART CONDITION
FEVER – INFANT, 104°F
NOSEBLEED – UNCONTROLLED
BLOOD PRESSURE 56/41 – IN AND OUT OF CON
RECTAL BLEEDING – ACTIVE
NON-EMERGENCY TRANSPORT
WEAKNESS – POSSIBLE TIA
VOMITING – MULTIPLE EPISODES
DIFFICULTY SWALLOWING – OBSTRUCTION SUSPECTED
COUGH – COVID POSITIVE
DEHYDRATION – ELDERLY, INCOHERENT
FIRE ALARM – COM BLDG
FIRE ALARM – RESIDENTIAL
STRUCTURE FIRE – SMOKE VISIBLE
VEHICLE FIRE – FULLY INVOLVED
SMOKE INVESTIGATION – OUTDOORS
GAS LEAK – ODOR INSIDE BUILDING
CO ALARM – MULTIPLE OCCUPANTS
POWER LINE DOWN – SPARKING
HAZMAT – CHEMICAL SPILL IN LAB
OUTSIDE FIRE – BRUSH AREA
ELEVATOR ENTRAPMENT – OCCUPIED
ODOR INVESTIGATION – UNKNOWN SOURCE
ELECTRICAL FIRE – CONTAINED TO ROOM
APPLIANCE FIRE – KITCHEN
LIGHTNING STRIKE – STRUCTURE DAMAGE
TRASH FIRE – NEAR BUILDING
MUTUAL AID REQUEST – FIRE COVERAGE
FIRE WATCH – SYSTEM OFFLINE
VEHICLE INTO BUILDING – STRUCTURAL DAMAGE
FIRE DRILL – NO RESPONSE NEEDED
DOMESTIC DISTURBANCE – VERBAL ONLY
ASSAULT – VICTIM BLEEDING
THEFT – IN PROGRESS
SUSPICIOUS PERSON – LINGERING
MISSING PERSON – JUVENILE
SHOTS FIRED – MULTIPLE CALLERS
FIGHT – MULTIPLE SUBJECTS
SUICIDAL SUBJECT – POSSIBLE WEAPON
TRAFFIC ACCIDENT – NO INJURIES
TRAFFIC ACCIDENT – INJURIES REPORTED
HIT AND RUN – WITNESS ON SCENE
MENTAL HEALTH CRISIS – REQUESTING C.I.T.
TRESPASSING – REFUSING TO LEAVE
VEHICLE BLOCKING ROADWAY
CHECK WELFARE – UNRESPONSIVE CALLER
INTOXICATED SUBJECT – PUBLIC PLACE
BURGLARY – ALARM TRIPPED
ACTIVE SHOOTER – SHELTER IN PLACE
ROBBERY – SUSPECT FLED ON FOOT
MISSING ELDERLY – DEMENTIA PATIENT
KIDNAPPING – POSSIBLE PARENTAL
ARMED SUBJECT – GUN SEEN
NOISE COMPLAINT – MULTIPLE CALLS
HARASSMENT – EX-PARTNER
LOUD MUSIC – VEHICLE PARKED
ILLEGAL DUMPING – CAUGHT ON CAMERA
ANIMAL COMPLAINT – DOG BITE
CIVIL DISPUTE – LANDLORD/TENANT
FIREWORKS COMPLAINT – OUT OF SEASON
ROAD HAZARD – DEBRIS IN LANE
ALARM COMPANY REPORT – NO RESPONSE FROM PREMISE
WEATHER RELATED – TREE DOWN
FLOODING – BASEMENT, POSSIBLE HAZARDS
SEARCH AND RESCUE – HIKER LOST
WATER RESCUE – PERSON IN RIVER
MUTUAL AID – EMS COVERAGE REQUEST
DISASTER RESPONSE – TORNADO TOUCHDOWN
MEDICAL STANDBY – PUBLIC EVENT
EVACUATION – ORDER ISSUED
UNKNOWN EMERGENCY – CALL DISCONNECTED
BOMB THREAT – EVACUATION UNDERWAY
AMBULANCE REPLACEMENT NEEDED – UNIT DISABLED
SPECIAL NEEDS TRANSPORT – WHEELCHAIR ACCESS
HOSPITAL DIVERSION – REDIRECT UNIT
LIFT ASSIST – NO INJURY
DEATH NOTIFICATION – POLICE ENROUTE
NON-BREATHER INFANT – CPR STARTED
INTERFACILITY TRANSFER – CRITICAL PATIENT
PRISONER TRANSPORT – MEDICAL NEED
REQUEST FOR SUPERVISOR – SCENE ESCALATING